50
50
35
5
BBBBBBBBBBBBBBBBBBBBBBBBBBBBBBBBBBBBBBBBBBBBBBBBBB
BBBBBBBBBBBBBBBBBBBBBBBBBBBBBBBBBBBBBBBBBBBBBBBBBB
BB                      BBBBBBBBBB               B
B                        BBBBBBBB    oooooooo  G B
B              8         BBBBBBBB                B
B              I         BBBBBBBB   BBBBBBBBBBBBBB
B       ooooooooooooo    BBBBBBBB   BBBBBBBBBBBBBB
BBBBB             E E|   BBBBBBBBXXXB           BB
BBBBBBBBBBBBBBBBBBBBB o  BBBBBBBB                B
BBBBBBBBBBBBBBBBBBBBBXX  BBBBBBBB   ooooXoooo    B
BBBBBBBBBBBBBBBBBBBBB    BBBBBBBB              o B
BBBBBBBBBBBBBBBBBBBBB  o BBBBBBBBEEEEEEEEEEEEB   B
BBBBBBBBBBBBBBBBBBBBB  XXBBBBBBBBBBBBBBBBBBBBBXXXB
BB                 BB    BBBBBBBBBBBBBBBBBBBBB   B
B                   B o  BBBBBBBBBBBBBBBBBBBBB o B
B     8 B           BXX  BBBBBBB             B   B
B oo  I BXX              BBBBBB              BXXXB
B       B   ooooo   oooooBBBBBB    8             B
B oo    B  E   E |       BBBBBB    I    o    o   B
B    BBBBBBBBBBBB   BBBBBBBBBBB       | E || E | B
BXXXXBBBBBBBBBBBBAAABBBBBBBBBBB o      BBB  BBB  B
B    BBBBBBBBBBBBBBBBBBBBBBBBBB o BBBAABBBAABBBAAB
B oo BBBBBBBBBBBBBBBBBBBBBBBBBB o BBBBBBBBBBBBBBBB
B    BBBBBBBBBBBBBBBBBBBBBBBBBB o BBBBBBBBBBBBBBBB
BXXXXBBBBBBBBBBBBBBBBBBBBBBBBBBXXXB             BB
B    BBBBBBBBBBBBBBBBBBBBBBBBBB                  B
B                BBBBBBBBBBBBBB    ooooooooo     B
B     oooooooo    BBBBBBBBBBBBB                  B
B     E       E   BBBBBBBBBBBBB    E   E   E   E B
BBBBBBBBBBBBBBXXXXBBBBBBBBBBBBBBBBBBBBBBBBBBXXXXXB
BBBBBBBBBBBBBB    BBBBBBBBBBBBBBBBBBBBBBBBBB     B
BBBBBBBBBBBBBB oo BBBBBBBBBBBBBBBBBBBBBBBBBB o   B
BBBBBBBBBBBBBB    BBBBBoooooBBBBBBBBBBBBBBBCXXX  B
BBBBBBBBBBBBBBXXXXBBBBBoooooBBBBBBBBBBBBCCCC     B
BBBBBBBBBBBBBB    BBBBBoooooCCCCCCCCCCCCCBBB   o B
B         l    oo BBBBBXXXXXBBBBBBBBBBBBBBBB  XXXB
B  8  F   l       BBBBBoooooBBBBBBBBBBBBBBBB     B
B  I      BBBBXXXXBBBBBoooooBBBBBBBBBBBBBBBB o   B
B E   E   BBBB    BBBBBoooooBBBBBBBBBBBBBBBBXXX  B
BoooooooooBBBB oo BBBBBBBBBBBBBBBBBBBBBBBBB      B
BBBBBBBBBBBBBB    BBBBBBBBBBBBBBB              o B
BBBBBBBBBBBBBBXXXXBBBBBBBBBBBBBBB        8    XXXB
BBBBBBBBBBBBBB    BBBBBBBBBBBBBBBB       I       B
BB            oooo       BBBBBB BB  H   ooooo    B
B          |     E  |    BBBBB o B    |    E  |  B
B    ooooo  XXXXXXXX     BBBBBo oB     BBBBBBB   B
B    ooooo                   B B B BBBBBBBBBBB   B
B                        o   B B B BBBBBBBBBBBAAAB
B  |  E  E  E  E  E  E  |      B   BBBBBBBBBBBBBBB
B   BBBBBBBBBBBBBBBBBBBB   BBBBBBBBBBBBBBBBBBBBBBB





