1,2,4,1,2,3,1,1,5,1,5,1,1
3,3,2,5,5,5,5,6,6,6,6,6,1
1,4,4,3,1,4,1,1,1,6,1,6,1
1,4,6,6,6,6,6,6,1,6,1,6,1
1,4,1,4,1,1,1,6,6,6,4,6,1
1,4,6,6,6,6,1,6,1,6,1,6,1
1,4,1,1,1,6,1,6,1,6,1,6,1
1,4,6,6,1,6,2,6,1,6,6,6,1
1,1,1,6,2,6,1,6,1,6,1,6,1
1,6,1,6,1,6,1,6,6,6,1,6,1
1,6,1,6,2,6,1,6,1,6,1,6,1
1,6,1,6,1,6,1,6,1,6,1,6,1
1,6,1,6,2,6,1,6,1,6,1,6,1
1,6,1,6,1,6,4,6,1,6,1,6,1
1,6,6,6,1,6,6,6,1,6,1,6,1
1,6,1,1,1,1,1,1,1,6,1,6,1
1,6,6,6,6,3,6,6,6,6,1,6,1
1,1,1,1,1,1,1,1,1,1,1,6,1
1,6,6,6,6,3,4,6,6,6,6,6,1
1,1,1,1,1,6,1,1,1,1,1,1,1
1,6,6,6,1,6,6,6,6,6,6,6,1
1,6,1,6,1,6,1,6,1,1,4,6,1
1,6,1,6,6,6,1,6,6,6,1,6,1
1,1,2,2,1,2,1,1,1,1,1,6,1
